................
................
................
................
................
................
.........NP.....
................
..AC.........AC.
AGHF.NBP.....DJC
DEEF.......AGHEF
DEEF.......LIIIM
